#############################
#.........    ........      #
#..  ###.. #            ### #
#..        #.... . ##     # #
#..        #.... . # # ...# #
#..  ###.  #         # ...# #
#..               #### .... #
#    #                 .... #
#..  #  #   .      ##       #
#.#           #     .  ######
#.  ..#     . #.       #    #
## *        . #.. #    # #  #
#  ..   .   .     #         #
#       .   ...*          # #
# ***   . . ....**     . *  #
#....       ######    ##### #
#.... **          ***       #
#....****...# ##..... R.... #
#...........#   ....   .... #
#...........#.       # ###. #
#....     ..#.... ...#  ... #
#........ ..#.... ...#..... #
#........         ........#*#
###########################O#