#############################
#..........................\#
#..\\###...#....        ###.#
#......... #.... ..##\\..\#.#
#..\*\.... #.... ..#\#....#.#
#...\###.. #\\\. ....#....#.#
#... ..... ..... .####......#
#\\. #..\\...        .......#
#... #..#. .....*\ ##.......#
#.#....... ...#..  ....######
#. ...#.\\ ...#.\  ....#..* #
##.\...... ...#.. #....#.#\\#
#.....*... .....*\#\\.....*.#
#.***.* .\.....*\****.....#.#
#.\.... ................   .#
#.......   .######    ##### #
#....\\.................... #
#....****...#.##............#
#...........#.........\....\#
#...........#.\\.    #\###.\#
#....     ..#.... ...#\\... #
#........ ..#.... ...#..... #
#........         ........#R#
###########################L#