############
#..........#
#.....*....#
#..\\\\\\..#
#.     ....#
#..\\\\\\\.#
#..\..    .#
#..\.. ....#
#..... ..  #
#..### ###*#
#...R#\#\\.#
######L##### 